NO ./path_to_the_north_texture
SO ./path_to_the_south_texture
WE ./path_to_the_west_texture
EA ./path_to_the_east_texture

F 220,100,0
C 225,30,0

111111111
100000001
1000000011111111
1000100000000S01
1000000000000001
1000000000000001
1000000000000001
1000000000000001
1001110011111111
1001 1001
1111 1111