NO srcs/textures/wall.xpm
SO srcs/textures/wall.xpm
WE srcs/textures/wall.xpm
EA srcs/textures/wall.xpm

F 220,100,0
C 225,30,0

11111111
100000001
1000000011111111
100010000000E001
1000000000000001
1000000000000001
1000000000000001
1000000000000001
1001110011111111
1001 1001
1111 1111