NO srcs/textures/wall.xpm
SO srcs/textures/wall.xpm
WE srcs/textures/wall.xpm
EA srcs/textures/wall.xpm

F 169,169,169
C 135,206,235

111111111111111111111
1E0000000000000000001
100000100000000000001
100000100000000000001
100000100000000000001
100000100000000000001
100000000000001000001
100000100000000000001
100100000000000000001
111111111111111111111
111111111111111111111
111111111111111111111