NO srcs/textures/
SO srcs/textures/NO.xpm
WE srcs/textures/WE.xpm
EA srcs/textures/EA.xpm

F 200,160,90
C 135,206,235

11111111111
10010000101
10000000001
10110011101
10101010101
10001N10001
11111111111
