NO srcs/textures/NO.xpm
SO srcs/textures/NO.xpm
WE srcs/textures/WE.xpm
EA srcs/textures/EA.xpm

F 200,160,90
C 135,206,235

1111
1001
10N1
1111
