NO srcs/textures/wall.xpm
SO srcs/textures/wall.xpm
WE srcs/textures/wall.xpm
EA srcs/textures/wall.xpm

F 169,169,169
C 135,206,235

11111111111111111111
1E000001000000010001
10000000000000000001
10111010101110101001
10000000000000000001
10001010100010101001
11101010111110101111
10000010100000100001
10111110101111110101
10000000001000000101
10101111111101110101
10001000000001000101
11101011110111010111
10001010000100010001
10111010111110111001
10000010000000100001
11111111111111111111


